+++    ++++++    ++++
+++    ++++++    ++++
+       S          ++
+                  ++
+                  ++
+ ++++++  +++++++  ++
+             +    ++
+             +    ++
+       P     +    ++
+                  ++
+                  ++
+++++++++   +++++++++
+                  ++
+ ++++++    +   +  ++
+           +   +  ++
+           +   +  ++
+           +   +  00
+ ++++++           00
+                  00
+                  00
+++++++++++++++++++++
